############################
#             #            #
#             #            #
#    .                  ####
#                          #
###########                #
#                   .      #
#             #            #
#             #            #
############################